   :::::::::::''  ''::'      '::::::  `:::::::::::::'.:::::::::::::::
   :::::::::' :. :  :         ::::::  :::::::::::.:::':::::::::::::::
   ::::::::::  :   :::.       :::::::::::::..::::'     :::: : :::::::
   ::::::::    :':  "::'     '"::::::::::::: :'           '' ':::::::
   :'        : '   :  ::    .::::::::'    '                        .:
   :               :  .:: .::. ::::'                              :::
   :. .,.        :::  ':::::::::::.: '                      .:...::::
   :::::::.      '     .::::::: '''                         :: :::::.
   ::::::::            ':::::::::  '',            '    '   .:::::::::
   ::::::::.        :::::::::::: '':,:   '    :         ''' :::::::::
   ::::::::::      ::::::::::::'                        :::::::::::::
   : .::::::::.   .:''::::::::    '         ::   :   '::.::::::::::::
   :::::::::::::::. '  '::::::.  '  '     :::::.:.:.:.:.:::::::::::::
   :::::::::::::::: :     ':::::::::   ' ,:::::::::: : :.:'::::::::::
   ::::::::::::::::: '     :::::::::   . :'::::::::::::::' ':::::::::
   ::::::::::::::::::''   :::::::::: :' : ,:::::::::::'      ':::::::
   :::::::::::::::::'   .::::::::::::  ::::::::::::::::       :::::::
   :::::::::::::::::. .::::::::::::::::::::::::::::::::::::.'::::::::
   :::::::::::::::::' :::::::::::::::::::::::::::::::::::::::::::::::
   ::::::::::::::::::.:::::::::::::::::::::::::::::::::::::::::::::::